8 1
********
********
0*0*****
********
********
********
**00*0**
0*00****

00000022
01222226
01244556
11334566
13344567
13445567
13455667
13377777
