8 2
1***0*0*
********
*1***0*1
*****00*
***0**11
**0*1***
0******1
******1*

********
********
********
********
********
********
********
********
