8 3
*2*111**
0*21*2**
0****2**
****02**
*******0
*1*1102*
1*2*****
00****20

********
********
********
********
********
********
********
********
