8 3
***111**
****0*12
*210**02
22*1**0*
0*00****
***201**
1*******
**22****

********
********
********
********
********
********
********
********
