4 1
********
**0*****
********
********
*0****0*
******0*
********
********

00001111
01111331
01101331
00001131
20223333
20023223
20022223
22223333
