4 2
********
********
**1*00**
*1******
********
********
***0**0*
****11**

********
********
********
********
********
********
********
********
