8 1
********
********
0*******
********
********
**0*****
*00**0*0
**00****

00000011
04555771
04456671
33456771
34456721
34556721
34666721
33322222
