8 2
***0**0*
*****1**
**111***
***11***
**11**0*
******0*
****0***
00*****0

********
********
********
********
********
********
********
********
