8 1
********
********
********
*****0**
***0****
****0*0*
****0*00
*******0

76661122
77766112
55746612
35744612
35774412
35555412
33333442
00000000
