8 2
**00*01*
********
0******1
1******0
********
1*******
1*******
00*1110*

********
********
********
********
********
********
********
********
