8 2
*1******
*0******
*00*****
*11*0***
1**100**
****00**
*1****1*
*******1

********
********
********
********
********
********
********
********
