8 3
00****22
*****2**
01*1***1
**11***0
*211**00
***22***
***1**20
*2*0****

********
********
********
********
********
********
********
********
