4 2
********
********
*0*001*0
********
********
1*******
1*1*****
********

********
********
********
********
********
********
********
********
