4 2
11******
*****00*
********
********
**00**1*
********
********
******1*

********
********
********
********
********
********
********
********
