8 2
*00*****
*1*****0
***0****
11******
*******0
1*1***11
*1*0****
*****0*0

********
********
********
********
********
********
********
********
