8 2
1***0***
**1*****
*1***00*
*00****0
11******
**1*****
****0***
11*0****

********
********
********
********
********
********
********
********
