8 2
******1*
********
**0111**
***0001*
***001**
**0*****
1****0**
****1***

********
********
********
********
********
********
********
********
