8 2
0*****0*
**111***
**1*1**0
**111***
********
*0**0***
0**0****
*****0**

********
********
********
********
********
********
********
********
