4 3
11******
*2***2**
********
*0**0***
********
**110***
****022*
********

********
********
********
********
********
********
********
********
