4 2
********
********
*10*0***
****0***
********
******0*
**1*****
***11***

********
********
********
********
********
********
********
********
