8 2
********
*1*1*1**
********
***1****
**0001**
**010***
**000*1*
*1******

********
********
********
********
********
********
********
********
