8 3
*2******
*1******
*20**21*
10*2*01*
1**00*1*
1*200*1*
****0*2*
**22****

********
********
********
********
********
********
********
********
