8 2
****1110
1******0
********
1*******
0*0*****
0***000*
1*******
*1****1*

********
********
********
********
********
********
********
********
