8 3
****22**
*1*0***1
1**0****
1**2012*
1**01*0*
*1*0****
***0****
**2022*2

********
********
********
********
********
********
********
********
