8 2
11******
*******0
**0**1*0
*0*000**
********
*0**1**1
****1***
1****1**

********
********
********
********
********
********
********
********
