8 2
1***10**
*1**01*0
********
******0*
***1****
***1*1**
***0*0**
10****0*

********
********
********
********
********
********
********
********
