4 2
********
********
*1******
*1******
00*****0
*******0
******11
********

********
********
********
********
********
********
********
********
