8 3
11******
****21**
*2*****0
*0202***
200***10
2*001*2*
*2******
***111**

********
********
********
********
********
********
********
********
