8 2
111**00*
*****1**
********
*1***0**
*0*1****
****1***
*1******
*000***0

********
********
********
********
********
********
********
********
