4 2
********
*******0
*******0
********
*0******
*0**11**
**11****
********

********
********
********
********
********
********
********
********
