8 2
****110*
********
1**0****
11**0**0
*1*****0
*******0
0*******
*0***11*

********
********
********
********
********
********
********
********
