8 2
**1*00**
*******1
********
1******1
0*****10
0******0
0*******
*11*1*0*

********
********
********
********
********
********
********
********
