4 3
********
*1***21*
**0*0***
2*******
**1****0
********
**2****1
*0****2*

********
********
********
********
********
********
********
********
