8 2
***00**0
1*11***1
00******
**1*****
10*****0
******1*
*****1**
0*******

********
********
********
********
********
********
********
********
