8 3
*****11*
2*****00
1*2**0**
*021**0*
**22***2
00*****2
****1*02
111*****

********
********
********
********
********
********
********
********
